##########################
#                        #
#                        #
#    #                   #
#    #                   #
#    #                   #
#    #                   #
#    ###                 #
#                        #
#                        #
#                  #     #
#            #######     #
#                        #
#                        #
#                        #
##########################
